11111111111111111
1PC00100001000001
11101110101011101
10100000101010111
10001011100010001
10111000111110101
10101011100000101
10101010001111101
10001011101000001
11111000101011101
10101110101000101
10100010101110111
10101000101000001
10101111101011111
10000000001000CE1
11111111111111111