11111111111111111111111111111111111111
1P000000000000000000000000000000000001
10000000000000000000000000000000000001
100CCCC0CCCC000C0000CCCC0C000C0CCCC001
100C0000C00C000C0000C00C0CC00C0C000001
100CCCC0C00C000C0000C00C0C0C0C0C0CC001
100000C0C00C000C0000C00C0C00CC0C00C001
100CCCC0CCCC000CCCC0CCCC0C000C0CCCC001
10000000000000000000000000000000000001
100000000000000000000000000000000000E1
11111111111111111111111111111111111111