11111
1P001

10C01
100E1
11111